1111111111111111
1010000110000101
1010111111110101
1010000000000101
1000001111000001
1111000000001111
1000000000000001
1001110000111001
1111111111111111